8x8
########
#>.....#
####.#.#
#X##.#.#
#.###..#
#....#.#
####...#
########