8x8
########
#......#
####.#.#
#.##.#.#
#.###..#
#....#.#
####...#
########