8x8
########
#......#
###.##.#
#v#.##.#
#.#.X#.#
#.####.#
#......#
########