10x10
##########
#>.......#
#.######.#
#.#...#..#
#.#.#..#.#
#.#.##.#.#
#.#X#..#.#
#.###.##.#
#..#.....#
##########